11111111111111
1P00000C000001
10100100111101
10100100000101
1011111C0110C1
10000100100001
10000100111101
1C0000000000E1
11111111111111
