1111111
1P00001
1111101
1C000C1
1011111
10000E1
1111111
