1111111
1C00001
100C001
1111001
1CP00C1
1E00001
1111111
