11111111111111
1P00100C0000C1
10101010111101
10101010100001
10101010101111
101C1010100001
1011101C111101
1C0000111E0001
11111111111111