11111
1CEC1
10001
1CPC1
11111
