111111111111111
1P0000000110001
101111101011101
1000000010000C1
111011111110111
1C0100000000E11
111111111101011
1C0000000000001
111111111111111
