11111111111111111111
1P0000000000000000C1
10111110111110111101
10000000100000000001
11101111111011110111
1C0000000000E00000C1
11111011110101111111
1C000100001000000001
10111110111110111101
11111111111111111111
