1111111111111111111111111
1P000000000000000000000C1
1011111011111011111011101
1000000010000000000000001
1110111111101111111111011
1C0000000000E0000000000C1
1111101111010111111111111
1C00000000100000000000001
1011111011111011111011111
1C00000000000000000000001
1110111111101111111111011
1000000010000000000000001
1011111011111011111011101
1C000000000000000000000E1
1111111111111111111111111
