111111111111
1C000P0000C1
100111111001
10C0000000C1
11110P011111
1E00000000C1
111111111111

