111111111111
1000000000o1
100111111001
100000000001
11110P011111
1E0000000001
111111111111
