111111111111
1C00000000C1
100111111000
10C0000000C1
11110P011111
1E00000000C1
111111111111
