1111111
1P00001
1011101
1C001C1
1011101
10000E1
1111111
